1
 #####
 #   ####
## #$   #
# $  $$ #
# #$#.!.#
#@   ...#
#########