1
 #########
##       #
#  $#$#  #
#     a$.#
#  ###!.!#
##########