S5 
#########
#    .  #
#$  $$$.#
#  # . ##
#. ##$ #
#### $.#
#.@$   #
####   #
   #####

