2
 #####
 #   ####
## #$   #
# $  $$ #
# #$#.!.#
#   @...#
#########