1
 #########
##       #
#   #$#$_#
# $$  .$.#
# @###...#
##########