4
##########
#@.......#
#  ########
#         #
# $ $ $ $ #
##### #####
 #  $ $  #
 # $     #
 #       #
 #########
